the whole game is a touramentent 

gator wrestle: calculate distance to gator

calculate distance to gator : calculate angle to gator 

calculate angle to gator: prepare for gator wrestle

prepare for gator wrestle : position gator, angle gator

position gator: sprint to gator, sneak to gator, move away from gator

angle gator: rotate right of gator, rotate left of gator

sneak to gator: gator response

move away from gator : gator response 

rotate right of gator : gator response  

rotate left of gator : gator response

gator response : gator focus, gator unfocus  

gator focus: gator charge attack , gator ignore

gator focus : gator increase interest, gator flee

gator charge attack: gator attack spin

gator flee: jump on gator, allow escape 

sprint to gator: jump on gator

jump on gator : gator attack spin

gator attack spin: gator attack spin land, gator attack spin miss

gator attack spin land : gator attack spin wound

gator attack spin miss : gator attack spin response

gator attack spin response : fly under gator,  tackled gator wound , fly over gator

fly under gator : gator attack spin

fly over gator : gator attack spin 

tackled gator wound : tackled gator 

tackled gator : maintain grip, control alligator mouth, elbow drop, kiss gator head , carry gator 

tackled gator : gator neck choke, close eyes, secure hind legs, fully extend gator head back

gator elbow drop: elbow drop

elbow drop : tackled gator wound

tackled gator wound: fractured gator jaw with broken teeth  

ponds primals: miltary base, alligator farm
