explorer of betrt:

spouse of lixie: 

spouse of betrt:

caregiver of lixie:

caregiver of betrt: 

prophet of lixie: 

prophet of betrt:

sage of betrt: 

sage of lixie: 

innocent of lixie:

innocent of betrt: 

aesthetic of lixie: 

aesthetic of betrt: 

ruler of lixie:

ruler of betrt:

clown of lixie:

clown of betrt:

champion of betrt: bright

champion of lixie:  

ambassador of betrt:

ambassador of lixie:

citizen of lixie:

citizen of betrt:

betrt bright : make bold move 

make bold move : push back into business, sacrifice for knowledge, comes clean with family

 ultimate showdown 
 
prometheus postmodern dougherty  : promo, 04 blessed, aesthetic of betrt

iona something : iona, 04 blessed, aesthetic of betrt

catharsis gale : gale, 04 blessed, spouse of lixie

cherp cherp quint: cherp, 04 blessed, caregiver of lixie

orbie mayhaw : orbie, 04 blessed, prophet of lixie

johnny-walkman : johnny, 04 blessed, sage of betrt

cecilia rogers rules : zero, 04 blessed, sage of betrt

art hallow : art, 04 blessed, sage of lixie

bili fae bots : bili, 04 blessed, caregiver of lixie

pistol grip whip: grip, 04 blessed, caregiver of lixie

korona klick : bili, 04 blessed, innocent of lixie

karly marbles : karly, 04 blessed, innocent of lixie

mary fatback : mary, 04 blessed, innocent of lixie

simon beeing : simon, 04 blessed, aesthetic of lixie

rosa beeing : rosa, 04 blessed, ruler of lixie

bitcoin rittle : bitcoin, 04 blessed, ruler of betrt

sequenomn : nomn, 04 blessed, ruler of betrt

aystrel wyld quynessence : wyld, 04 blessed, clown of betrt

celebritisaurus rex : saurus, 04 blessed, clown of betrt

camp indians : camp, 04 blessed, explorer of lixie

rc spurl : spurl, 04 blessed, explorer of lixie

aperiocity chill : chill, 04 blessed, explorer of betrt

little dixson jimmie: jimmie, 04 blessed, explorer of lixie

pulpwood mcquiag : pulp, 04 blessed, explorer of lixie

phinehas phuckle phin : phin, 04 blessed, spouse of betrt

nancy rittle : nancy, 04 blessed, spouse of betrt

serious-saul-saint-nikodemus : saul, 04 blessed, champion of betrt

triton-arcage : triton, 04 blessed, champion of betrt

warden man : warden, 04 blessed, champion of lixie

ryan david : ryan, 04 blessed, champion of betrt

mika metrologikal : mika, 04 blessed, ambassador of betrt

binocular parralax : bino, 04 blessed, ambassador of betrt

kbar mc killikutty : kbar, 04 blessed, citizen of lixie

poor piss : piss, 04 blessed, citizen of lixie

fused buck up : buck, 04 blessed, citizen, lixie

bonni bluff : bonni, 04 blessed, citizen, lixie 

petra beeing : petra, 04 blessed, citizen, lixie 

jodie of the bundead : jodie, 04 blessed, citizen, lixie 

mika metrologikal : mika, 04 blessed, citizen of lixie 

spoogee : spooge, 04 blessed, citizen of lixie 

feed kornblith : feed, 04 blessed, citizen of lixie



